{
  "id": "ashen_peak",
  "name": "Ashen Peak",
  "cols": 35,
  "rows": 30,
  "grid": [
    [1,1,1,1,1,1,1,1,1,1,1,1,1,1,1,1,1,1,1,1,1,1,1,1,1,1,1,1,1,1,1,1,1,1,1],
    [1,4,4,4,4,4,4,4,4,4,4,1,0,0,0,0,0,0,0,0,0,0,0,1,4,4,4,4,4,4,4,4,4,4,1],
    [1,4,4,4,4,4,4,4,4,4,4,1,0,0,0,0,0,0,0,0,0,0,0,1,4,4,4,4,4,4,4,4,4,4,1],
    [1,4,4,4,4,4,4,4,4,4,4,1,0,0,0,0,0,0,0,0,0,0,0,1,4,4,4,4,4,4,4,4,4,4,1],
    [1,4,4,4,4,4,4,4,4,4,4,1,0,0,0,0,0,0,0,0,0,0,0,1,4,4,4,4,4,4,4,4,4,4,1],
    [1,4,4,4,4,4,4,4,4,4,4,1,0,0,0,0,0,0,0,0,0,0,0,1,4,4,4,4,4,4,4,4,4,4,1],
    [1,4,4,4,4,4,4,4,4,4,4,1,1,1,1,1,3,3,3,1,1,1,1,1,4,4,4,4,4,4,4,4,4,4,1],
    [1,4,4,4,4,4,4,4,4,4,4,1,0,0,0,0,3,0,3,0,0,0,0,1,4,4,4,4,4,4,4,4,4,4,1],
    [1,4,4,4,4,4,4,4,4,4,4,1,0,0,0,0,3,0,3,0,0,0,0,1,4,4,4,4,4,4,4,4,4,4,1],
    [1,4,4,4,4,4,4,4,4,4,4,1,1,1,2,2,2,2,2,2,2,1,1,1,4,4,4,4,4,4,4,4,4,4,1],
    [1,4,4,4,4,4,4,4,4,4,4,1,0,0,2,2,2,2,2,2,2,0,0,1,4,4,4,4,4,4,4,4,4,4,1],
    [1,4,4,4,4,4,4,4,4,4,4,1,0,0,2,2,2,2,2,2,2,0,0,1,4,4,4,4,4,4,4,4,4,4,1],
    [1,4,4,4,4,4,4,4,4,4,4,1,12,12,12,12,12,12,12,12,12,12,12,1,4,4,4,4,4,4,4,4,4,4,1],
    [1,4,4,4,4,4,4,4,4,4,4,1,0,0,0,0,3,0,3,0,0,0,0,1,4,4,4,4,4,4,4,4,4,4,1],
    [1,4,4,4,4,4,4,4,4,4,4,1,0,0,0,0,3,0,3,0,0,0,0,1,4,4,4,4,4,4,4,4,4,4,1],
    [1,4,4,4,4,4,4,4,4,4,4,1,0,0,0,0,3,0,3,0,0,0,0,1,4,4,4,4,4,4,4,4,4,4,1],
    [1,4,4,4,4,4,4,4,4,4,4,1,1,1,2,2,2,2,2,2,2,1,1,1,4,4,4,4,4,4,4,4,4,4,1],
    [1,4,4,4,4,4,4,4,4,4,4,1,0,0,2,2,2,2,2,2,2,0,0,1,4,4,4,4,4,4,4,4,4,4,1],
    [1,4,4,4,4,4,4,4,4,4,4,1,0,0,2,2,2,2,2,2,2,0,0,1,4,4,4,4,4,4,4,4,4,4,1],
    [1,4,4,4,4,4,4,4,4,4,4,1,12,12,12,12,12,12,12,12,12,12,12,1,4,4,4,4,4,4,4,4,4,4,1],
    [1,4,4,4,4,4,4,4,4,4,4,1,0,0,0,0,3,0,3,0,0,0,0,1,4,4,4,4,4,4,4,4,4,4,1],
    [1,4,4,4,4,4,4,4,4,4,4,1,0,0,0,0,3,0,3,0,0,0,0,1,4,4,4,4,4,4,4,4,4,4,1],
    [1,4,4,4,4,4,4,4,4,4,4,1,0,0,0,0,3,0,3,0,0,0,0,1,4,4,4,4,4,4,4,4,4,4,1],
    [1,4,4,4,4,4,4,4,4,4,4,1,0,0,0,0,3,0,3,0,0,0,0,1,4,4,4,4,4,4,4,4,4,4,1],
    [1,4,4,4,4,4,4,4,4,4,4,1,0,0,0,0,3,0,3,0,0,0,0,1,4,4,4,4,4,4,4,4,4,4,1],
    [1,4,4,4,4,4,4,4,4,4,4,1,0,0,0,0,3,0,3,0,0,0,0,1,4,4,4,4,4,4,4,4,4,4,1],
    [1,4,4,4,4,4,4,4,4,4,4,1,0,0,0,0,3,0,3,0,0,0,0,1,4,4,4,4,4,4,4,4,4,4,1],
    [1,4,4,4,4,4,4,4,4,4,4,1,0,0,0,0,3,0,3,0,0,0,0,1,4,4,4,4,4,4,4,4,4,4,1],
    [1,4,4,4,4,4,4,4,4,4,4,1,0,0,0,0,3,3,3,0,0,0,0,1,4,4,4,4,4,4,4,4,4,4,1],
    [1,1,1,1,1,1,1,1,1,1,1,1,1,1,1,1,1,0,1,1,1,1,1,1,1,1,1,1,1,1,1,1,1,1,1]
  ],
  "exits": [
    { "col": 17, "row": 29, "targetMap": "port_breeze", "targetCol": 10, "targetRow": 14, "direction": "DOWN" }
  ],
  "npcs": [
    { "npcId": "ashen_guardian", "col": 17, "row": 3 }
  ],
  "encounterZone": "ashen_peak",
  "playerSpawn": { "x": 17, "y": 28 },
  "biomeType": "volcano",
  "isSafeZone": false
}