{
  "id": "crystal_caves",
  "name": "Crystal Caves",
  "cols": 30,
  "rows": 25,
  "grid": [
    [1,1,1,1,1,1,1,1,1,1,1,1,1,1,1,3,1,1,1,1,1,1,1,1,1,1,1,1,1,1],
    [1,1,1,1,1,1,1,1,1,1,1,1,1,1,3,3,3,1,1,1,1,1,1,1,1,1,1,1,1,1],
    [1,1,1,1,1,1,1,1,1,1,1,1,1,3,3,0,3,3,1,1,1,1,1,1,1,1,1,1,1,1],
    [1,1,1,1,1,1,1,1,1,1,1,1,3,3,0,0,0,3,3,1,1,1,1,1,1,1,1,1,1,1],
    [1,1,1,1,1,5,5,1,1,1,1,3,3,0,0,0,0,0,3,3,1,1,1,5,5,1,1,1,1,1],
    [1,1,1,1,1,5,0,0,0,0,3,3,0,0,0,0,0,0,0,3,3,0,0,0,5,1,1,1,1,1],
    [1,1,1,1,1,5,0,0,0,3,3,0,0,4,4,0,0,4,4,0,3,3,0,0,5,1,1,1,1,1],
    [1,1,1,1,1,1,0,0,3,3,0,0,4,4,4,0,0,4,4,4,0,3,3,0,0,1,1,1,1,1],
    [1,1,1,1,1,1,0,3,3,0,0,0,0,4,4,0,0,4,4,0,0,0,3,3,0,1,1,1,1,1],
    [1,1,1,1,1,1,3,3,0,0,0,0,0,0,0,0,0,0,0,0,0,0,0,3,0,1,1,1,1,1],
    [1,1,1,0,0,3,3,0,0,0,3,2,2,2,3,12,3,0,0,0,0,0,0,3,3,0,0,1,1,1],
    [1,1,0,0,3,3,0,0,0,0,3,2,2,2,3,12,3,0,0,5,5,0,0,0,3,3,0,0,1,1],
    [1,1,0,3,3,0,0,0,0,0,3,2,2,2,3,12,3,0,5,5,5,5,0,0,0,3,3,0,1,1],
    [1,0,3,3,0,0,0,0,0,0,3,2,2,2,3,12,3,0,0,5,5,0,0,0,0,0,3,3,0,1],
    [1,0,3,0,0,0,0,0,0,0,3,3,3,3,3,3,3,0,0,0,0,0,0,0,0,0,0,3,0,1],
    [1,0,3,3,0,0,0,0,0,0,0,0,0,0,0,0,0,0,0,0,0,0,0,0,0,0,3,3,0,1],
    [1,1,0,3,3,0,0,0,0,0,0,0,0,0,0,0,0,0,0,0,0,0,0,0,0,3,3,0,1,1],
    [1,1,0,0,3,3,0,0,3,2,2,2,3,12,3,0,0,0,4,4,4,0,0,0,3,3,0,0,1,1],
    [1,1,1,0,0,3,3,0,3,2,2,2,3,12,3,0,0,4,4,4,4,4,0,3,3,0,0,1,1,1],
    [1,1,1,0,0,0,3,0,3,2,2,2,3,12,3,0,0,0,4,4,4,0,0,3,0,0,0,1,1,1],
    [1,1,1,1,0,0,3,3,3,3,3,3,3,3,3,0,0,0,0,0,0,0,3,3,0,0,1,1,1,1],
    [1,1,1,1,1,0,0,0,0,0,0,0,0,0,0,0,0,0,0,0,0,3,3,0,0,1,1,1,1,1],
    [1,1,1,1,1,1,0,0,0,0,0,0,0,0,3,3,3,0,0,0,3,3,0,0,1,1,1,1,1,1],
    [1,1,1,1,1,1,1,1,0,0,0,0,0,3,3,3,3,3,0,0,0,0,1,1,1,1,1,1,1,1],
    [1,1,1,1,1,1,1,1,1,1,1,1,1,1,1,3,1,1,1,1,1,1,1,1,1,1,1,1,1,1]
  ],
  "exits": [
    { "col": 15, "row": 0, "targetMap": "summit_outpost", "targetCol": 6, "targetRow": 8, "direction": "UP" },
    { "col": 15, "row": 24, "targetMap": "port_breeze", "targetCol": 15, "targetRow": 1, "direction": "DOWN" }
  ],
  "npcs": [
    { "npcId": "crystal_explorer", "col": 7, "row": 9 }
  ],
  "encounterZone": "crystal_caves",
  "playerSpawn": { "x": 15, "y": 1 },
  "biomeType": "mountain",
  "isSafeZone": false
}