{
  "id": "desert_pass",
  "name": "Scorched Dunes",
  "cols": 35,
  "rows": 25,
  "grid": [
    [1, 1, 1, 1, 1, 1, 1, 1, 1, 1, 1, 1, 1, 1, 1, 1, 1, 1, 1, 3, 3, 3, 1, 1, 1, 1, 1, 1, 1, 1, 1, 1, 1, 1, 1],
    [1, 0, 0, 0, 1, 1, 1, 1, 1, 1, 1, 1, 0, 0, 0, 0, 1, 1, 3, 3, 3, 3, 3, 1, 1, 1, 0, 0, 0, 0, 0, 0, 0, 0, 1],
    [1, 0, 0, 0, 0, 1, 1, 1, 1, 10, 10, 1, 0, 0, 0, 0, 0, 3, 3, 0, 3, 0, 3, 3, 1, 1, 0, 0, 0, 0, 0, 0, 0, 0, 1],
    [1, 0, 0, 0, 0, 0, 1, 1, 10, 10, 0, 0, 0, 0, 0, 0, 0, 3, 0, 0, 0, 0, 0, 3, 1, 1, 0, 0, 0, 1, 1, 0, 0, 0, 1],
    [1, 1, 0, 0, 0, 0, 0, 10, 10, 0, 0, 0, 2, 2, 0, 0, 3, 3, 0, 0, 0, 0, 0, 3, 3, 1, 1, 0, 1, 1, 0, 0, 0, 0, 1],
    [1, 1, 1, 0, 0, 0, 0, 10, 0, 0, 0, 2, 2, 2, 2, 0, 3, 0, 0, 0, 2, 0, 0, 0, 3, 1, 1, 1, 1, 0, 0, 0, 0, 0, 1],
    [1, 1, 1, 1, 10, 10, 10, 10, 2, 2, 2, 2, 2, 2, 2, 2, 3, 0, 0, 2, 2, 2, 0, 0, 3, 0, 0, 0, 0, 0, 0, 0, 0, 0, 1],
    [1, 0, 0, 1, 1, 10, 10, 0, 0, 0, 0, 2, 2, 0, 0, 0, 3, 0, 0, 0, 2, 0, 0, 0, 3, 0, 0, 0, 0, 0, 0, 1, 1, 1, 1],
    [1, 0, 0, 0, 1, 1, 0, 0, 0, 0, 0, 0, 0, 0, 4, 4, 3, 0, 0, 0, 0, 0, 0, 3, 3, 0, 0, 0, 1, 1, 1, 1, 0, 0, 1],
    [1, 0, 0, 0, 0, 0, 0, 0, 0, 0, 0, 0, 0, 4, 4, 4, 4, 3, 0, 0, 0, 0, 3, 3, 1, 1, 1, 1, 1, 0, 0, 0, 0, 0, 1],
    [1, 0, 0, 0, 0, 0, 0, 0, 0, 0, 0, 0, 0, 4, 4, 4, 4, 0, 3, 3, 3, 3, 3, 1, 1, 0, 0, 0, 0, 0, 0, 0, 0, 0, 1],
    [1, 3, 3, 0, 0, 0, 0, 11, 0, 0, 0, 0, 0, 0, 4, 4, 0, 0, 0, 0, 0, 0, 1, 1, 0, 0, 0, 0, 0, 0, 0, 0, 0, 1, 1],
    [3, 3, 3, 3, 3, 0, 0, 0, 0, 0, 0, 0, 0, 0, 0, 0, 0, 0, 0, 0, 0, 1, 1, 0, 0, 0, 0, 0, 0, 0, 0, 0, 1, 1, 1],
    [1, 3, 3, 0, 0, 0, 0, 0, 0, 0, 0, 0, 10, 10, 0, 0, 0, 0, 0, 0, 1, 1, 0, 0, 0, 0, 0, 1, 1, 0, 0, 1, 1, 0, 1],
    [1, 0, 0, 0, 0, 0, 0, 0, 0, 10, 10, 10, 10, 10, 10, 0, 0, 0, 0, 1, 1, 0, 0, 0, 0, 0, 1, 1, 0, 0, 0, 0, 0, 0, 1],
    [1, 1, 0, 0, 0, 0, 0, 0, 10, 10, 1, 1, 1, 1, 10, 10, 0, 0, 1, 1, 0, 0, 0, 0, 0, 1, 1, 0, 0, 0, 0, 0, 0, 0, 1],
    [1, 1, 1, 0, 0, 0, 0, 10, 10, 1, 1, 0, 0, 1, 1, 10, 0, 0, 1, 0, 0, 0, 0, 0, 1, 1, 0, 0, 0, 0, 0, 0, 0, 0, 1],
    [1, 0, 0, 0, 0, 0, 10, 10, 1, 1, 0, 0, 0, 0, 1, 10, 10, 0, 0, 0, 0, 0, 0, 1, 1, 0, 0, 0, 0, 0, 0, 0, 0, 0, 1],
    [1, 0, 0, 0, 0, 10, 10, 1, 1, 0, 0, 0, 0, 0, 0, 1, 10, 2, 2, 2, 2, 0, 1, 1, 0, 0, 0, 0, 1, 1, 0, 0, 0, 0, 1],
    [1, 0, 0, 0, 0, 0, 0, 0, 0, 0, 0, 0, 0, 0, 0, 10, 10, 2, 2, 2, 2, 10, 10, 0, 0, 0, 0, 1, 1, 0, 0, 0, 0, 0, 1],
    [1, 0, 0, 0, 0, 0, 0, 0, 0, 0, 0, 0, 0, 0, 0, 0, 10, 2, 2, 2, 2, 10, 0, 0, 0, 0, 1, 1, 0, 0, 0, 0, 0, 0, 1],
    [1, 0, 0, 0, 1, 1, 0, 0, 0, 0, 0, 0, 0, 0, 0, 0, 10, 10, 2, 2, 10, 10, 0, 0, 0, 0, 0, 0, 0, 0, 0, 0, 0, 0, 1],
    [1, 0, 0, 1, 1, 1, 1, 0, 0, 0, 0, 0, 0, 0, 0, 0, 0, 10, 10, 10, 10, 0, 0, 0, 0, 0, 0, 0, 0, 0, 0, 0, 0, 0, 1],
    [1, 0, 0, 0, 1, 1, 0, 0, 0, 0, 0, 0, 0, 0, 0, 0, 0, 0, 0, 0, 0, 0, 0, 0, 0, 0, 0, 0, 0, 0, 0, 0, 0, 0, 1],
    [1, 1, 1, 1, 1, 1, 1, 1, 1, 1, 1, 1, 1, 1, 1, 1, 1, 1, 1, 1, 1, 1, 1, 1, 1, 1, 1, 1, 1, 1, 1, 1, 1, 1, 1]
  ],
  "exits": [
    { "col": 0, "row": 12, "targetMap": "waystation", "targetCol": 10, "targetRow": 6, "direction": "LEFT" },
    { "col": 20, "row": 0, "targetMap": "tundra_ridge", "targetCol": 15, "targetRow": 23, "direction": "UP" }
  ],
  "npcs": [
    { "npcId": "desert_trader", "col": 20, "row": 8 }
  ],
  "encounterZone": "desert_pass",
  "playerSpawn": { "x": 2, "y": 12 },
  "biomeType": "desert",
  "isSafeZone": false
}