{
  "id": "forest_path",
  "name": "Whispering Woods",
  "cols": 35,
  "rows": 25,
  "grid": [
    [1,1,1,1,1,1,1,1,1,1,1,1,1,1,1,0,1,1,1,1,1,1,1,1,1,1,1,1,1,1,1,1,1,1,1],
    [1,1,1,1,1,0,0,0,0,0,1,1,1,0,3,3,3,0,1,1,1,0,0,0,0,0,0,1,1,1,1,1,1,1,1],
    [1,1,1,0,0,0,0,0,0,0,0,0,0,0,3,3,3,0,0,0,0,0,0,0,0,0,0,0,0,1,1,1,1,1,1],
    [1,1,0,0,0,0,0,11,0,0,0,0,0,0,3,3,3,0,0,0,0,0,2,2,0,0,0,0,0,0,1,1,1,1,1],
    [1,1,0,0,2,2,0,0,0,0,0,0,0,3,3,0,3,3,0,0,0,2,2,2,2,0,0,0,0,0,0,1,1,1,1],
    [1,1,1,0,0,2,2,0,0,0,0,0,3,3,0,0,0,3,3,0,0,0,2,2,0,0,0,0,0,1,1,1,1,1,1],
    [1,1,1,1,1,1,1,1,5,5,5,5,5,0,0,0,0,0,5,5,5,5,5,1,1,1,1,1,1,1,1,1,1,1,1],
    [1,1,1,1,1,1,1,1,5,2,2,2,2,2,2,2,2,2,2,2,2,2,5,1,1,1,1,1,1,1,1,1,1,1,1],
    [1,1,1,1,1,1,1,1,5,2,2,2,2,2,2,2,2,2,2,2,2,2,5,1,1,1,1,1,1,1,1,1,1,1,1],
    [1,1,1,1,1,1,1,1,5,5,5,5,5,0,0,3,0,0,5,5,5,5,5,1,1,1,1,1,1,1,1,1,1,1,1],
    [1,1,0,0,0,0,4,4,0,0,0,0,0,0,3,3,3,0,0,0,0,0,0,0,0,0,0,0,0,0,1,1,1,1,1],
    [1,1,0,0,0,4,4,4,4,0,0,0,0,3,3,0,3,3,0,0,0,0,0,0,2,2,0,0,0,0,1,1,1,1,1],
    [1,1,0,0,0,4,4,4,4,0,0,0,0,3,0,0,0,0,3,0,0,0,2,2,2,2,0,0,0,0,0,1,1,1,1],
    [1,1,0,0,0,0,4,4,0,0,0,0,3,3,0,0,0,0,3,3,0,0,0,2,2,0,0,0,0,0,1,1,1,1,1],
    [1,1,1,1,1,1,1,1,1,1,10,10,10,0,0,0,0,0,10,10,10,1,1,1,1,1,1,1,1,1,1,1,1,1,1],
    [1,1,1,1,1,1,1,1,1,1,10,2,2,2,2,2,2,2,2,2,10,1,1,1,1,1,1,1,1,1,1,1,1,1,1],
    [1,1,1,1,1,1,1,1,1,1,10,2,2,2,2,2,2,2,2,2,10,1,1,1,1,1,1,1,1,1,1,1,1,1,1],
    [1,1,1,1,1,1,1,1,1,1,10,10,10,0,0,3,0,0,10,10,10,1,1,1,1,1,1,1,1,1,1,1,1,1,1],
    [1,1,1,0,0,0,0,0,0,0,0,0,0,0,3,3,3,0,0,0,0,0,0,0,0,0,0,0,0,1,1,1,1,1,1],
    [1,1,0,0,0,0,0,0,0,0,0,0,0,3,3,0,3,3,0,0,0,0,0,0,0,0,0,0,0,0,1,1,1,1,1],
    [1,1,0,0,2,2,0,0,0,0,0,0,3,3,0,0,0,3,3,0,0,0,0,0,2,2,0,0,0,0,1,1,1,1,1],
    [1,1,1,1,1,1,1,1,1,1,5,5,5,5,0,0,0,5,5,5,5,1,1,1,1,1,1,1,1,1,1,1,1,1,1],
    [1,1,1,1,1,1,1,1,1,1,5,2,2,2,2,2,2,2,2,2,5,1,1,1,1,1,1,1,1,1,1,1,1,1,1],
    [1,1,1,1,1,1,1,1,1,1,5,5,5,5,0,3,3,0,5,5,5,1,1,1,1,1,1,1,1,1,1,1,1,1,1],
    [1,1,1,1,1,1,1,1,1,1,1,1,1,1,1,1,1,0,1,1,1,1,1,1,1,1,1,1,1,1,1,1,1,1,1]
  ],
  "exits": [
    { "col": 15, "row": 0, "targetMap": "town", "targetCol": 20, "targetRow": 23, "direction": "UP" },
    { "col": 17, "row": 24, "targetMap": "lake_shore", "targetCol": 15, "targetRow": 1, "direction": "DOWN" }
  ],
  "npcs": [
    { "npcId": "forest_ranger", "col": 17, "row": 12 }
  ],
  "encounterZone": "forest_path",
  "playerSpawn": { "x": 15, "y": 2 },
  "biomeType": "forest",
  "isSafeZone": false
}
