{
  "id": "forest_path",
  "name": "Whispering Woods",
  "cols": 35,
  "rows": 25,
  "grid": [
    [1,1,1,1,1,1,1,1,1,1,1,1,1,1,1,3,1,1,1,1,1,1,1,1,1,1,1,1,1,1,1,1,1,1,1],
    [1,9,9,0,0,0,0,0,0,0,0,0,3,3,3,3,3,3,0,0,0,0,0,0,0,0,9,9,1,1,1,1,1,1,1],
    [1,0,0,0,0,11,0,0,0,0,3,3,3,3,0,0,0,3,3,3,0,0,0,0,0,0,0,0,1,1,1,1,1,1,1],
    [1,0,4,4,0,0,0,0,0,3,3,3,0,0,0,0,0,0,3,3,3,3,0,0,0,0,4,4,1,1,1,1,1,1,1],
    [1,0,4,4,4,0,0,0,3,3,3,0,0,0,0,0,0,0,0,0,3,3,3,3,0,0,4,4,1,1,1,1,1,1,1],
    [1,0,0,0,0,0,0,3,3,3,0,0,0,0,0,0,0,0,0,0,0,0,0,3,3,3,3,0,0,1,1,1,1,1,1],
    [1,1,1,1,1,1,1,1,1,1,1,1,1,1,1,1,1,1,1,1,5,2,2,2,2,2,2,5,0,1,1,1,1,1,1],
    [1,1,1,1,1,1,1,1,1,1,1,1,1,1,1,1,1,1,1,1,5,2,2,2,2,2,2,5,13,1,1,1,1,1,1],
    [1,1,1,1,1,1,1,1,1,1,1,1,1,1,1,1,1,1,1,1,5,5,5,3,0,5,5,5,3,1,1,1,1,1,1],
    [1,0,0,0,0,0,0,0,0,0,0,0,0,0,0,0,0,0,0,0,0,0,3,3,3,0,0,0,3,1,1,1,1,1,1],
    [1,0,0,0,0,0,0,0,0,0,0,0,0,0,0,0,0,3,3,3,3,3,3,3,0,0,0,0,0,1,1,1,1,1,1],
    [1,0,0,0,0,0,0,0,0,0,0,0,0,3,3,3,3,3,3,3,3,0,0,0,0,0,0,0,0,1,1,1,1,1,1],
    [1,0,0,0,0,0,0,0,3,3,3,3,3,3,3,0,0,0,0,0,0,0,0,0,0,0,0,0,0,1,1,1,1,1,1],
    [1,1,1,1,1,1,5,2,2,2,2,2,2,5,0,1,1,1,1,1,1,1,1,1,1,1,1,1,1,1,1,1,1,1,1],
    [1,1,1,1,1,1,5,2,2,2,2,2,2,5,13,1,1,1,1,1,1,1,1,1,1,1,1,1,1,1,1,1,1,1,1],
    [1,1,1,1,1,1,5,5,5,3,0,5,5,5,3,1,1,1,1,1,1,1,1,1,1,1,1,1,1,1,1,1,1,1,1],
    [1,0,0,9,9,0,0,0,3,3,3,0,0,0,0,3,3,3,3,0,0,0,0,0,0,0,0,0,1,1,1,1,1,1,1],
    [1,0,0,0,0,0,0,0,0,3,3,3,0,0,0,0,3,3,3,3,0,0,0,0,0,0,0,0,1,1,1,1,1,1,1],
    [1,0,0,0,0,0,0,0,0,0,3,3,3,0,0,0,0,0,3,3,3,3,0,0,0,0,0,0,1,1,1,1,1,1,1],
    [1,1,1,1,1,1,1,1,1,9,9,1,1,1,1,1,0,5,2,2,2,2,2,2,5,1,1,1,1,1,1,1,1,1,1],
    [1,1,1,1,1,1,1,1,1,1,1,1,1,1,1,1,13,5,2,2,2,2,2,2,5,1,1,1,1,1,1,1,1,1,1],
    [1,1,1,1,1,1,1,1,1,1,1,1,1,1,1,1,3,5,5,5,3,0,5,5,5,1,1,1,1,1,1,1,1,1,1],
    [1,1,1,1,1,1,1,1,1,1,1,1,1,1,0,0,0,0,0,3,3,3,0,0,0,1,1,1,1,1,1,1,1,1,1],
    [1,1,1,1,1,1,1,1,1,1,1,1,1,1,1,0,0,3,3,0,3,3,0,1,1,1,1,1,1,1,1,1,1,1,1],
    [1,1,1,1,1,1,1,1,1,1,1,1,1,1,1,1,1,3,1,1,1,1,1,1,1,1,1,1,1,1,1,1,1,1,1]
  ],
  "exits": [
    {"col":15,"row":0,"targetMap":"town","targetCol":20,"targetRow":23,"direction":"UP"},
    {"col":17,"row":24,"targetMap":"lake_shore","targetCol":15,"targetRow":1,"direction":"DOWN"}
  ],
  "npcs": [
    {"npcId":"forest_ranger","col":14,"row":11}
  ],
  "encounterZone": "forest_path",
  "playerSpawn": {"x":15,"y":2},
  "biomeType": "forest",
  "isSafeZone": false
}
