{
  "id": "lake_shore",
  "name": "Crystal Lake",
  "cols": 35,
  "rows": 25,
  "grid": [
    [1,1,1,1,1,1,1,1,1,1,1,1,1,1,1,3,1,1,1,1,1,1,1,1,1,1,1,1,1,1,1,1,1,1,1],
    [1,0,0,0,0,0,0,0,0,0,0,0,0,0,3,3,3,0,0,0,0,0,0,0,0,0,0,0,0,0,0,0,0,0,1],
    [1,0,9,0,3,3,3,3,3,3,3,3,3,3,3,3,3,3,3,3,3,3,3,3,3,3,3,3,0,0,0,9,0,0,1],
    [1,0,0,0,3,0,0,0,0,0,0,0,0,0,0,3,0,0,0,0,0,0,0,0,0,0,0,3,1,1,1,1,1,1,1],
    [1,1,1,5,3,5,1,4,4,4,4,4,4,4,4,4,4,4,4,4,4,4,4,4,4,1,5,13,5,0,0,0,0,0,1],
    [1,1,1,5,3,0,1,4,4,4,4,4,4,4,4,4,4,4,4,4,4,4,4,4,4,1,5,0,5,0,9,0,0,0,1],
    [1,1,9,5,2,2,1,4,4,4,4,4,4,4,4,4,4,4,4,4,4,4,4,4,4,1,5,0,5,0,0,0,0,0,1],
    [1,1,0,5,2,2,1,4,4,4,4,4,4,4,4,4,4,4,4,4,4,4,4,4,4,5,5,0,5,0,0,0,0,0,1],
    [1,1,0,5,3,0,1,1,4,4,4,4,4,4,4,4,4,4,4,4,4,4,4,4,5,0,5,13,5,0,0,0,0,0,1],
    [1,1,0,5,2,2,0,1,4,4,4,4,4,4,4,4,4,4,4,4,4,4,4,4,5,0,5,0,5,0,0,0,0,0,1],
    [1,1,0,5,2,2,0,1,1,4,4,4,4,4,4,4,4,4,4,4,4,4,4,4,5,0,5,0,5,0,0,9,0,0,1],
    [1,1,9,5,3,0,0,0,1,4,4,4,4,4,4,4,4,4,4,4,4,4,4,1,5,0,5,0,5,0,0,0,0,0,1],
    [1,1,0,5,2,2,2,0,1,4,4,4,4,4,4,4,4,4,4,4,4,4,4,4,5,0,5,13,5,0,0,0,0,0,1],
    [1,1,0,5,2,2,2,0,1,4,4,4,4,4,4,4,4,4,4,4,4,4,4,4,5,0,5,0,5,0,0,0,0,0,1],
    [1,1,0,5,3,0,0,1,4,4,4,4,4,4,4,4,4,4,4,4,4,4,4,4,5,0,5,0,5,0,0,0,0,0,1],
    [1,1,0,5,2,2,0,1,4,4,4,4,4,4,4,4,4,4,4,4,4,4,4,4,5,0,5,0,5,0,9,0,0,0,1],
    [1,1,9,5,2,2,0,1,1,4,4,4,4,4,4,4,4,4,4,4,4,4,4,1,5,0,5,13,5,0,0,0,0,0,1],
    [1,1,0,5,3,0,0,0,1,1,4,4,4,4,4,4,4,4,4,4,4,4,1,1,5,0,5,0,5,0,0,0,0,0,1],
    [1,1,0,5,2,2,0,0,0,1,1,4,4,4,4,4,4,4,4,4,4,1,1,0,5,0,5,0,5,0,0,0,0,0,1],
    [1,1,0,5,3,0,0,0,0,0,0,4,4,4,4,4,4,4,4,4,0,0,0,0,5,0,5,0,5,0,0,0,0,0,1],
    [1,1,0,5,3,5,5,5,0,0,0,0,4,4,4,4,4,4,4,0,0,0,5,5,5,0,5,13,5,0,0,0,0,0,1],
    [1,0,0,0,3,3,0,0,0,0,0,0,0,0,3,3,3,3,3,0,0,0,0,0,0,0,0,0,0,3,0,0,0,0,1],
    [1,0,0,0,0,3,3,3,3,3,3,3,3,3,3,3,3,3,3,3,3,3,3,3,3,3,3,3,3,3,0,0,0,0,1],
    [1,0,0,0,0,0,0,0,0,0,0,0,0,0,0,0,3,3,3,0,0,0,0,0,0,0,0,0,0,0,0,0,0,0,1],
    [1,1,1,1,1,1,1,1,1,1,1,1,1,1,1,1,1,3,1,1,1,1,1,1,1,1,1,1,1,1,1,1,1,1,1]
  ],
  "exits": [
    { "col": 15, "row": 0, "targetMap": "forest_path", "targetCol": 17, "targetRow": 23, "direction": "UP" },
    { "col": 17, "row": 24, "targetMap": "lakeside_village", "targetCol": 5, "targetRow": 1, "direction": "DOWN" }
  ],
  "npcs": [
    { "npcId": "fisher", "col": 25, "row": 9 }
  ],
  "encounterZone": "lake_shore",
  "playerSpawn": { "x": 15, "y": 2 },
  "biomeType": "lake",
  "isSafeZone": false
}
