{
  "id": "lake_shore",
  "name": "Crystal Lake",
  "cols": 35,
  "rows": 25,
  "grid": [
    [1,1,1,1,1,1,1,1,1,1,1,1,1,1,1,3,1,1,1,1,1,1,1,1,1,1,1,1,1,1,1,1,1,1,1],
    [1,0,0,0,0,0,0,0,0,0,0,0,0,0,3,3,3,0,0,0,0,0,0,0,0,0,0,0,0,0,0,0,0,0,1],
    [1,0,0,0,0,0,0,0,0,0,0,0,0,0,0,3,0,11,0,0,0,0,0,0,0,0,0,0,0,0,0,0,0,0,1],
    [1,0,0,0,0,0,0,0,0,3,3,3,3,3,3,3,3,3,3,3,3,3,3,3,3,3,0,0,0,0,0,0,0,0,1],
    [1,0,0,0,0,0,0,0,3,3,0,0,0,0,0,0,0,0,0,0,0,0,0,0,0,3,3,0,0,0,0,0,0,0,1],
    [1,1,1,1,1,1,1,5,2,2,5,1,1,1,1,1,1,1,1,1,1,1,1,1,5,2,2,5,1,1,1,1,1,1,1],
    [1,0,0,0,0,0,0,0,2,2,0,0,4,4,4,4,4,4,4,4,4,4,4,0,0,2,2,0,0,0,0,0,0,0,1],
    [1,0,0,0,0,0,0,0,3,0,0,4,4,4,4,4,4,4,4,4,4,4,4,4,0,0,3,0,0,0,0,0,0,0,1],
    [1,0,0,0,0,0,0,0,3,0,4,4,4,4,4,4,4,4,4,4,4,4,4,4,4,0,3,0,0,0,0,0,0,0,1],
    [1,0,0,0,0,0,0,0,3,0,4,4,4,4,0,0,0,0,0,4,4,4,4,4,4,0,3,0,0,0,0,0,0,0,1],
    [1,0,0,0,0,0,0,0,3,0,4,4,4,0,0,0,0,0,0,0,4,4,4,4,4,0,3,0,0,0,0,0,0,0,1],
    [1,0,0,0,0,0,0,0,3,0,4,4,4,0,0,0,0,0,0,0,4,4,4,4,4,0,3,0,0,0,0,0,0,0,1],
    [1,0,0,0,0,0,0,0,3,0,4,4,4,4,0,0,0,0,0,4,4,4,4,4,4,0,3,0,0,0,0,0,0,0,1],
    [1,0,0,0,0,0,0,0,3,0,4,4,4,4,4,4,4,4,4,4,4,4,4,4,4,0,3,0,0,0,0,0,0,0,1],
    [1,0,0,0,0,0,0,0,3,0,4,4,4,4,4,4,4,4,4,4,4,4,4,4,4,0,3,0,0,0,0,0,0,0,1],
    [1,0,0,0,0,0,0,0,3,0,0,4,4,4,4,4,4,4,4,4,4,4,4,4,0,0,3,0,0,0,0,0,0,0,1],
    [1,0,0,0,0,0,0,0,3,0,0,0,4,4,4,4,4,4,4,4,4,4,4,0,0,0,3,0,0,0,0,0,0,0,1],
    [1,0,0,0,0,0,0,0,2,2,0,0,4,4,4,4,4,4,4,4,4,4,4,0,0,2,2,0,0,0,0,0,0,0,1],
    [1,1,1,1,1,1,1,5,2,2,5,1,1,1,1,1,1,1,1,1,1,1,1,1,5,2,2,5,1,1,1,1,1,1,1],
    [1,0,0,0,0,0,0,0,3,3,0,0,0,0,0,0,0,0,0,0,0,0,0,0,0,3,3,0,0,0,0,0,0,0,1],
    [1,0,0,0,0,0,0,0,0,3,3,3,3,3,3,3,3,3,3,3,3,3,3,3,3,3,0,0,0,0,0,0,0,0,1],
    [1,0,0,0,0,0,0,0,0,0,0,0,0,10,10,10,10,10,10,10,0,0,0,0,0,0,0,0,0,0,0,0,0,0,1],
    [1,0,0,0,0,0,0,0,0,0,0,0,0,0,0,0,0,0,0,0,0,0,0,0,0,0,0,0,0,0,0,0,0,0,1],
    [1,0,0,0,0,0,0,0,0,0,0,0,0,0,0,0,0,0,0,0,0,0,0,0,0,0,0,0,0,0,0,0,0,0,1],
    [1,1,1,1,1,1,1,1,1,1,1,1,1,1,1,1,1,3,1,1,1,1,1,1,1,1,1,1,1,1,1,1,1,1,1]
  ],
  "exits": [
    { "col": 15, "row": 0, "targetMap": "forest_path", "targetCol": 17, "targetRow": 23, "direction": "UP" },
    { "col": 17, "row": 24, "targetMap": "lakeside_village", "targetCol": 5, "targetRow": 1, "direction": "DOWN" }
  ],
  "npcs": [
    { "npcId": "fisher", "col": 25, "row": 15 }
  ],
  "encounterZone": "lake_shore",
  "playerSpawn": { "x": 15, "y": 2 },
  "biomeType": "lake",
  "isSafeZone": false
}