{
  "id": "mountain_pass",
  "name": "Mountain Pass",
  "cols": 35,
  "rows": 30,
  "grid": [
    [1,1,1,1,1,1,1,1,1,1,1,1,1,1,1,1,1,1,1,1,1,1,1,1,1,1,1,1,1,1,1,1,1,1,1],
    [1,1,1,1,1,1,1,1,1,1,1,1,1,1,1,1,1,1,1,1,0,0,0,0,0,0,0,0,0,0,0,0,0,0,1],
    [1,1,1,1,1,1,1,1,1,1,1,1,1,4,4,4,1,1,1,0,0,0,3,3,3,3,3,3,3,3,0,0,0,0,1],
    [1,1,1,1,1,1,1,1,1,1,1,1,4,4,4,4,4,1,0,0,0,3,3,0,0,0,0,0,0,3,3,0,0,0,1],
    [1,1,1,1,1,1,1,1,1,1,1,1,1,4,4,4,1,0,0,0,3,3,0,0,0,0,0,0,0,0,3,0,0,0,1],
    [1,1,1,1,1,1,1,1,1,1,1,1,1,1,1,1,0,0,0,3,3,0,0,0,3,2,2,2,3,12,3,0,0,0,1],
    [1,1,1,1,1,1,1,1,1,1,1,1,1,1,1,0,0,0,3,3,0,0,0,0,3,2,2,2,3,12,3,0,0,0,1],
    [1,1,1,1,1,1,1,1,1,1,1,1,1,1,0,0,0,3,3,0,0,0,0,0,3,2,2,2,3,12,3,0,0,0,1],
    [1,0,0,0,0,0,0,0,0,0,0,0,0,0,0,0,3,3,0,0,0,0,0,0,3,2,2,2,3,12,3,0,0,0,1],
    [1,0,0,0,0,0,0,0,0,10,10,10,0,0,0,3,3,0,0,0,0,0,0,0,3,3,3,3,3,3,3,0,0,0,1],
    [1,0,0,0,0,0,0,0,0,0,0,0,0,0,3,3,0,0,0,0,0,0,0,0,0,0,0,0,0,0,0,0,0,0,1],
    [1,0,0,0,0,0,0,0,0,0,0,0,0,3,3,0,0,0,0,0,1,1,1,1,1,1,1,1,0,0,0,0,0,0,1],
    [1,0,0,0,0,0,0,0,0,0,0,0,3,3,0,0,0,0,0,1,1,1,1,1,1,1,1,1,1,0,0,0,0,0,1],
    [1,0,3,3,3,3,3,3,0,0,0,3,3,0,0,0,0,0,1,1,1,1,1,1,1,1,1,1,1,1,0,0,0,0,1],
    [1,0,3,2,2,2,3,12,3,0,3,3,0,0,0,0,0,1,1,1,1,4,4,4,4,4,1,1,1,1,1,0,0,0,1],
    [3,3,3,2,2,2,3,12,3,3,3,0,0,0,0,0,1,1,1,1,4,4,4,4,4,4,4,1,1,1,1,0,0,0,3],
    [1,0,3,2,2,2,3,12,3,0,0,0,0,0,0,0,0,1,1,1,1,4,4,4,4,4,1,1,1,1,0,0,0,0,1],
    [1,0,3,2,2,2,3,12,3,0,0,0,0,0,0,0,0,0,1,1,1,1,1,1,1,1,1,1,1,0,0,0,0,0,1],
    [1,0,3,3,3,3,3,3,3,0,0,0,0,0,0,0,0,0,0,0,1,1,1,1,1,1,1,1,0,0,0,0,0,0,1],
    [1,0,0,0,0,0,0,0,0,0,0,0,0,0,0,0,0,0,0,0,0,0,0,0,0,0,0,0,0,0,0,0,0,0,1],
    [1,0,0,0,0,0,0,0,0,0,0,0,0,0,0,0,0,0,0,0,0,0,0,0,0,3,3,3,3,3,3,0,0,0,1],
    [1,0,0,0,0,0,0,0,0,0,0,0,0,0,0,0,0,0,0,0,0,0,0,0,3,3,0,0,0,0,3,3,0,0,1],
    [1,0,0,0,0,0,0,0,0,0,0,0,0,0,0,10,10,10,0,0,0,0,0,3,3,0,0,0,0,0,3,0,0,0,1],
    [1,0,0,0,0,0,0,0,0,0,0,0,0,0,0,0,0,0,0,0,0,0,3,3,0,0,3,2,2,2,3,12,3,0,1],
    [1,0,0,0,0,0,0,0,0,0,0,0,0,0,0,0,0,0,0,0,0,3,3,0,0,0,3,2,2,2,3,12,3,0,1],
    [1,0,0,0,0,0,0,0,0,0,0,0,0,0,0,0,0,0,0,0,3,3,0,0,0,0,3,2,2,2,3,12,3,0,1],
    [1,0,0,0,0,0,0,0,0,0,0,0,0,0,11,0,0,0,0,3,3,0,0,0,0,0,3,3,3,3,3,3,3,0,1],
    [1,0,0,0,0,0,0,0,0,0,0,0,0,0,0,0,0,0,3,3,0,0,0,0,0,0,0,0,0,0,0,0,0,0,1],
    [1,0,0,0,0,0,0,0,0,0,0,0,0,0,0,0,0,0,0,0,0,0,0,0,0,0,0,0,0,0,0,0,0,0,1],
    [1,1,1,1,1,1,1,1,1,1,1,1,1,1,1,1,1,1,1,1,1,1,1,1,1,1,1,1,1,1,1,1,1,1,1]
  ],
  "exits": [
    { "col": 0, "row": 15, "targetMap": "ember_town", "targetCol": 12, "targetRow": 6, "direction": "LEFT" },
    { "col": 34, "row": 15, "targetMap": "summit_outpost", "targetCol": 1, "targetRow": 5, "direction": "RIGHT" }
  ],
  "npcs": [
    { "npcId": "mountain_climber", "col": 10, "row": 19 }
  ],
  "encounterZone": "mountain_pass",
  "playerSpawn": { "x": 1, "y": 15 },
  "biomeType": "mountain",
  "isSafeZone": false
}