{
  "id": "port_breeze",
  "name": "Port Breeze",
  "cols": 20,
  "rows": 16,
  "grid": [
    [1, 1, 1, 1, 1, 1, 1, 1, 1, 1, 1, 1, 1, 1, 1, 3, 1, 1, 1, 1],
    [1, 0, 8, 8, 8, 8, 0, 0, 0, 0, 0, 0, 0, 8, 8, 8, 8, 0, 4, 1],
    [1, 0, 6, 6, 6, 6, 0, 0, 9, 9, 0, 0, 0, 6, 6, 6, 6, 0, 4, 1],
    [1, 0, 6, 6, 6, 6, 0, 0, 0, 0, 0, 11, 0, 6, 6, 6, 6, 0, 4, 1],
    [1, 0, 6, 6, 6, 6, 0, 0, 3, 3, 3, 3, 0, 6, 6, 6, 6, 0, 4, 1],
    [1, 0, 6, 6, 7, 6, 0, 0, 3, 0, 0, 3, 0, 6, 6, 7, 6, 0, 4, 1],
    [1, 0, 0, 0, 3, 0, 0, 0, 3, 0, 0, 3, 0, 0, 0, 3, 0, 0, 4, 1],
    [1, 0, 0, 0, 3, 3, 3, 3, 3, 0, 0, 3, 3, 3, 3, 3, 0, 0, 4, 1],
    [3, 3, 3, 3, 3, 0, 0, 0, 3, 0, 3, 3, 0, 0, 0, 3, 3, 3, 4, 1],
    [1, 0, 0, 0, 3, 0, 0, 0, 3, 0, 3, 0, 0, 0, 0, 0, 0, 0, 4, 1],
    [1, 0, 5, 0, 3, 0, 0, 0, 3, 3, 3, 0, 0, 0, 0, 0, 0, 0, 4, 1],
    [1, 0, 5, 0, 3, 0, 9, 0, 0, 0, 3, 0, 9, 0, 0, 0, 0, 0, 4, 1],
    [1, 0, 0, 0, 3, 0, 0, 0, 0, 0, 3, 0, 0, 0, 5, 5, 5, 0, 4, 1],
    [1, 0, 0, 0, 3, 3, 3, 3, 3, 3, 3, 0, 0, 0, 0, 0, 0, 0, 4, 1],
    [1, 0, 0, 0, 0, 0, 0, 0, 0, 0, 3, 0, 0, 0, 0, 0, 0, 0, 4, 1],
    [1, 1, 1, 1, 1, 1, 1, 1, 1, 1, 3, 1, 1, 1, 1, 1, 1, 1, 1, 1]
  ],
  "exits": [
    { "col": 0, "row": 8, "targetMap": "coastal_road", "targetCol": 33, "targetRow": 12, "direction": "LEFT" },
    { "col": 15, "row": 0, "targetMap": "crystal_caves", "targetCol": 15, "targetRow": 23, "direction": "UP" },
    { "col": 10, "row": 15, "targetMap": "ashen_peak", "targetCol": 17, "targetRow": 28, "direction": "DOWN" },
    { "col": 4, "row": 5, "targetMap": "port_clinic", "targetCol": 4, "targetRow": 4, "direction": "UP" },
    { "col": 15, "row": 5, "targetMap": "port_shop", "targetCol": 3, "targetRow": 4, "direction": "UP" }
  ],
  "npcs": [
    { "npcId": "port_npc1", "col": 8, "row": 10 },
    { "npcId": "port_npc2", "col": 14, "row": 10 }
  ],
  "encounterZone": null,
  "playerSpawn": { "x": 10, "y": 8 },
  "biomeType": "coastal",
  "isSafeZone": true
}
