{
  "id": "swamp_depths",
  "name": "Swamp Depths",
  "cols": 35,
  "rows": 25,
  "grid": [
    [1,1,1,1,1,1,1,1,1,1,1,1,1,1,1,1,1,3,1,1,1,1,1,1,1,1,1,1,1,1,1,1,1,1,1],
    [1,0,0,4,4,0,0,0,0,0,0,0,0,0,3,3,3,3,0,0,0,0,0,0,0,0,0,0,0,0,4,4,0,0,1],
    [1,0,0,4,4,4,0,0,0,0,0,0,0,0,3,0,0,0,0,0,0,0,0,0,0,0,0,0,0,0,4,4,0,0,1],
    [1,0,0,0,4,4,0,0,0,0,0,0,0,0,3,0,0,0,0,4,4,0,0,0,0,0,0,0,0,4,4,0,0,0,1],
    [1,0,0,0,0,0,0,0,0,0,0,0,0,0,3,0,0,0,0,4,4,0,0,0,0,0,0,0,0,0,0,0,0,0,1],
    [1,0,0,0,0,0,3,3,3,3,3,3,3,3,3,0,0,0,0,0,0,3,3,3,3,3,3,3,3,0,0,0,0,0,1],
    [1,0,0,0,0,0,3,0,0,0,0,0,0,0,0,0,0,0,0,0,0,0,0,0,0,0,0,0,3,0,0,0,0,0,1],
    [1,0,0,4,0,0,3,0,3,2,2,2,3,12,3,0,0,0,0,0,3,2,2,2,3,12,3,0,3,0,0,4,0,0,1],
    [1,0,0,4,4,0,3,0,3,2,2,2,3,12,3,0,0,0,0,0,3,2,2,2,3,12,3,0,3,0,4,4,0,0,1],
    [1,0,0,0,0,0,3,0,3,2,2,2,3,12,3,0,0,0,0,0,3,2,2,2,3,12,3,0,3,0,0,0,0,0,1],
    [1,0,0,0,0,0,3,0,3,2,2,2,3,12,3,0,0,0,0,0,3,2,2,2,3,12,3,0,3,0,0,0,0,0,1],
    [1,0,0,0,0,0,3,0,3,3,3,3,3,3,3,3,3,3,3,3,3,3,3,3,3,3,3,0,3,0,0,0,0,0,1],
    [1,0,0,0,0,0,3,0,0,0,0,0,0,0,0,0,0,0,0,0,0,0,0,0,0,0,0,0,3,0,0,0,0,0,1],
    [1,0,0,0,0,0,3,3,3,3,3,3,3,3,3,3,3,3,3,3,3,3,3,3,3,3,3,3,3,0,0,0,0,0,1],
    [1,0,0,4,4,0,0,0,0,0,0,0,0,0,0,0,0,0,0,0,0,0,0,0,0,0,0,0,0,0,4,4,0,0,1],
    [1,0,0,4,4,0,0,0,0,0,0,0,0,0,0,0,0,0,0,0,0,0,0,0,0,0,0,0,0,0,4,4,0,0,1],
    [1,0,0,0,0,0,3,3,3,3,3,3,3,3,3,3,3,3,3,3,3,3,3,3,3,3,3,3,3,0,0,0,0,0,1],
    [1,0,0,0,0,0,3,0,0,0,0,0,0,0,0,0,0,0,0,0,0,0,0,0,0,0,0,0,3,0,0,0,0,0,1],
    [1,0,0,0,0,0,3,0,3,3,3,3,3,3,3,3,3,3,3,3,3,3,3,3,3,3,3,0,3,0,0,0,0,0,1],
    [1,0,0,4,0,0,3,0,3,2,2,2,3,12,3,0,0,0,0,0,3,2,2,2,3,12,3,0,3,0,0,4,0,0,1],
    [1,0,0,4,4,0,3,0,3,2,2,2,3,12,3,0,0,0,0,0,3,2,2,2,3,12,3,0,3,0,4,4,0,0,1],
    [1,0,0,0,0,0,3,0,3,2,2,2,3,12,3,0,0,0,0,0,3,2,2,2,3,12,3,0,3,0,0,0,0,0,1],
    [1,0,0,0,0,0,3,3,3,3,3,3,3,3,3,3,3,3,3,3,3,3,3,3,3,3,3,3,3,0,0,0,0,0,1],
    [1,0,0,4,4,0,0,0,0,0,0,0,0,0,0,3,3,3,3,3,0,0,0,0,0,0,0,0,0,0,4,4,0,0,1],
    [1,1,1,1,1,1,1,1,1,1,1,1,1,1,1,1,1,3,1,1,1,1,1,1,1,1,1,1,1,1,1,1,1,1,1]
  ],
  "exits": [
    { "col": 17, "row": 0, "targetMap": "lakeside_village", "targetCol": 5, "targetRow": 8, "direction": "UP" },
    { "col": 17, "row": 24, "targetMap": "bogmire_village", "targetCol": 7, "targetRow": 1, "direction": "DOWN" }
  ],
  "npcs": [
    { "npcId": "swamp_witch", "col": 17, "row": 12 }
  ],
  "encounterZone": "swamp_depths",
  "playerSpawn": { "x": 17, "y": 1 },
  "biomeType": "swamp",
  "isSafeZone": false
}