{
  "id": "town",
  "name": "Spirit Haven",
  "cols": 30,
  "rows": 25,
  "grid": [
    [1,1,1,1,1,1,1,1,1,1,1,1,1,1,1,1,1,1,1,1,1,1,1,1,1,1,1,1,1,1],
    [1,0,0,0,0,0,0,0,0,0,0,0,0,0,0,0,0,0,0,0,0,0,0,0,0,0,0,0,0,1],
    [1,0,8,8,8,0,0,0,0,0,8,8,8,8,8,0,0,0,0,0,0,0,0,0,0,0,0,0,0,1],
    [1,0,6,6,6,0,0,0,0,0,6,6,6,6,6,0,0,0,0,0,0,0,9,0,9,0,0,0,0,1],
    [1,0,6,7,6,0,0,9,0,0,6,6,7,6,6,0,0,3,3,3,3,0,0,0,0,0,9,0,0,1],
    [1,0,0,3,0,0,0,0,0,0,0,0,3,0,0,0,0,3,0,0,3,0,0,0,0,0,0,0,0,1],
    [1,3,3,3,3,3,3,3,3,3,3,3,3,3,3,3,3,3,0,0,3,0,0,4,4,0,0,0,0,1],
    [1,0,0,0,0,0,0,0,0,0,0,0,3,0,0,0,0,3,0,0,3,0,4,4,4,4,0,0,0,1],
    [1,0,0,0,0,5,5,5,5,5,0,0,3,0,0,0,0,3,3,3,3,0,0,4,4,0,0,0,0,1],
    [1,0,8,8,8,5,0,9,0,5,0,0,3,0,0,0,0,0,0,0,0,0,0,0,0,0,0,0,0,1],
    [1,0,6,6,6,5,0,0,0,5,0,0,3,0,10,10,10,10,10,0,0,0,0,5,5,5,5,5,5,1],
    [1,0,6,7,6,5,0,0,0,5,0,0,3,0,0,0,0,0,0,0,0,2,2,0,2,2,0,0,0,1],
    [1,0,0,3,0,5,5,0,5,5,0,0,3,0,0,2,2,0,2,2,2,2,0,2,2,0,2,2,0,1],
    [1,3,3,3,3,3,3,3,3,3,3,3,3,0,2,0,2,2,0,2,0,2,0,2,0,2,0,2,0,1],
    [1,0,0,0,0,0,0,0,0,0,0,0,3,0,0,2,2,0,2,0,2,2,2,0,2,0,2,0,0,1],
    [1,0,9,0,0,0,0,0,0,0,0,0,3,0,2,2,0,2,2,2,0,2,0,2,2,0,0,2,0,1],
    [1,0,0,0,0,11,0,0,0,0,0,0,3,0,0,2,2,0,0,2,2,0,2,2,0,0,0,0,0,1],
    [1,0,0,0,9,0,0,9,0,0,0,0,3,0,0,0,2,2,0,0,2,0,0,0,0,0,0,0,0,1],
    [1,0,0,0,0,0,0,0,0,0,0,0,3,0,0,0,0,0,0,0,0,0,0,0,0,0,0,0,0,1],
    [1,0,0,8,8,8,0,0,0,0,0,0,3,0,0,0,0,0,0,0,0,0,0,0,0,0,0,0,0,1],
    [1,0,0,6,6,6,0,0,0,0,0,0,3,0,0,0,0,0,0,0,11,0,0,0,0,0,0,0,0,1],
    [1,0,0,6,7,6,0,0,0,0,0,0,3,0,0,0,0,0,0,3,3,3,0,0,0,0,0,0,0,1],
    [1,0,0,0,3,0,0,0,3,3,3,3,3,0,0,0,0,0,0,3,0,3,0,0,0,0,0,0,0,1],
    [1,0,0,0,3,3,3,3,3,0,0,0,0,0,0,0,0,0,0,3,0,3,0,0,0,0,0,0,0,1],
    [1,1,1,1,1,1,1,1,1,1,1,1,1,1,1,1,1,1,1,1,3,1,1,1,1,1,1,1,1,1]
  ],
  "exits": [
    { "col": 3, "row": 4, "targetMap": "home", "targetCol": 4, "targetRow": 5, "direction": "UP" },
    { "col": 12, "row": 4, "targetMap": "sanctuary", "targetCol": 5, "targetRow": 7, "direction": "UP" },
    { "col": 3, "row": 11, "targetMap": "town_clinic", "targetCol": 4, "targetRow": 3, "direction": "UP" },
    { "col": 4, "row": 21, "targetMap": "town_shop", "targetCol": 3, "targetRow": 3, "direction": "UP" },
    { "col": 28, "row": 13, "targetMap": "wild_steppe", "targetCol": 2, "targetRow": 15, "direction": "RIGHT", "requiredFlag": "hasFirstSpirit" },
    { "col": 20, "row": 24, "targetMap": "forest_path", "targetCol": 15, "targetRow": 1, "direction": "DOWN", "requiredFlag": "hasFirstSpirit" }
  ],
  "npcs": [
    { "npcId": "gate_guard", "col": 27, "row": 13 },
    { "npcId": "villager_1", "col": 7, "row": 7 },
    { "npcId": "villager_2", "col": 2, "row": 17 }
  ],
  "encounterZone": null,
  "playerSpawn": { "x": 12, "y": 8 },
  "biomeType": "town",
  "isSafeZone": true
}
