{
  "id": "tundra_ridge",
  "name": "Frostpeak Ridge",
  "cols": 35,
  "rows": 25,
  "grid": [
    [1,1,1,1,1,1,1,1,1,1,1,1,1,1,1,1,1,1,1,1,1,1,1,1,1,1,1,1,1,1,1,1,1,1,1],
    [1,0,0,0,1,1,1,0,0,0,1,1,0,0,0,0,0,0,0,0,0,0,1,1,0,0,0,1,1,1,0,0,0,0,1],
    [1,0,0,0,0,1,0,0,0,0,0,0,0,0,3,3,0,3,3,0,0,0,0,0,0,0,0,0,1,0,0,0,0,0,1],
    [1,0,0,0,0,0,0,0,1,1,0,0,0,3,3,0,0,0,3,3,0,0,0,1,1,0,0,0,0,0,0,1,0,0,1],
    [1,1,0,0,0,0,0,1,1,1,1,0,0,3,0,0,0,0,0,3,0,0,1,1,1,1,0,0,0,0,1,1,0,0,1],
    [1,1,1,1,1,10,10,10,10,10,1,1,10,10,10,2,2,2,10,10,10,1,1,10,10,10,10,10,1,1,1,1,1,1,1],
    [1,0,0,0,0,0,0,0,0,0,0,0,0,0,0,2,0,0,0,0,0,0,0,0,0,0,0,0,0,0,0,0,0,0,3],
    [1,0,0,0,0,0,0,0,0,0,0,0,0,0,0,2,11,2,0,0,0,0,0,0,0,0,0,0,0,0,0,0,0,0,1],
    [1,0,0,1,1,0,0,1,1,0,0,0,0,0,0,0,0,0,0,0,0,0,0,1,1,0,0,1,1,0,0,0,0,0,1],
    [1,0,1,1,1,1,0,1,1,4,4,4,4,4,0,3,0,3,0,4,4,4,4,4,1,1,0,1,1,1,1,0,0,0,1],
    [1,0,1,1,1,1,0,0,4,4,4,4,4,4,4,3,0,3,4,4,4,4,4,4,4,0,0,1,1,1,1,0,0,0,1],
    [1,0,1,1,1,1,0,0,4,4,4,4,4,4,4,3,0,3,4,4,4,4,4,4,4,0,0,1,1,1,1,0,0,0,1],
    [1,0,1,1,1,1,0,0,4,4,4,4,4,4,0,3,0,3,0,4,4,4,4,4,4,0,0,1,1,1,1,0,0,0,1],
    [1,0,0,1,1,0,0,1,1,0,4,4,4,0,0,3,3,3,0,0,4,4,4,0,1,1,0,0,1,1,0,0,0,0,1],
    [1,0,0,0,0,0,0,1,0,0,0,0,0,0,0,0,0,0,0,0,0,0,0,0,0,1,0,0,0,0,0,0,0,0,1],
    [1,1,1,1,1,10,10,10,10,10,1,1,10,10,10,2,2,2,10,10,10,1,1,10,10,10,10,10,1,1,1,1,1,1,1],
    [1,0,0,0,0,0,0,0,0,0,0,0,0,0,0,2,2,2,0,0,0,0,0,0,0,0,0,0,0,0,0,0,0,0,1],
    [1,0,0,0,0,0,0,0,0,0,0,0,0,0,0,2,2,2,0,0,0,0,0,0,0,0,0,0,0,0,0,0,0,0,1],
    [1,0,0,0,0,1,1,0,0,0,0,0,0,0,0,3,3,3,0,0,0,0,0,0,0,1,1,0,0,0,0,0,0,0,1],
    [1,1,1,1,1,10,10,10,10,10,1,1,10,10,10,2,2,2,10,10,10,1,1,10,10,10,10,10,1,1,1,1,1,1,1],
    [1,0,0,0,0,0,0,0,0,0,0,0,0,0,0,2,2,2,0,0,0,0,0,0,0,0,0,0,0,0,0,0,0,0,1],
    [1,0,0,0,0,0,0,0,0,0,0,0,0,0,0,2,2,2,0,0,0,0,0,0,0,0,0,0,0,0,0,0,0,0,1],
    [1,0,0,0,0,0,0,1,1,0,0,0,0,0,3,3,0,3,3,0,0,0,0,1,1,0,0,0,0,0,0,0,0,0,1],
    [1,0,0,0,0,0,0,0,0,0,0,0,0,0,0,3,3,3,0,0,0,0,0,0,0,0,0,0,0,0,0,0,0,0,1],
    [1,1,1,1,1,1,1,1,1,1,1,1,1,1,1,0,1,1,1,1,1,1,1,1,1,1,1,1,1,1,1,1,1,1,1]
  ],
  "exits": [
    { "col": 15, "row": 24, "targetMap": "desert_pass", "targetCol": 20, "targetRow": 1, "direction": "DOWN" },
    { "col": 34, "row": 6, "targetMap": "volcanic_trail", "targetCol": 1, "targetRow": 12, "direction": "RIGHT" }
  ],
  "npcs": [
    { "npcId": "ice_hermit", "col": 17, "row": 6 }
  ],
  "encounterZone": "tundra_ridge",
  "playerSpawn": { "x": 15, "y": 22 },
  "biomeType": "tundra",
  "isSafeZone": false
}