{
  "id": "volcanic_trail",
  "name": "Volcanic Trail",
  "cols": 35,
  "rows": 25,
  "grid": [
    [1,1,1,1,1,1,1,1,1,1,1,1,1,1,1,1,1,1,1,1,1,1,1,1,1,1,1,1,1,1,1,1,1,1,1],
    [1,0,0,0,0,0,1,1,0,0,0,0,0,0,0,0,0,0,1,1,4,4,1,1,0,0,0,0,0,0,0,0,0,0,1],
    [1,0,0,0,0,0,0,1,0,0,0,0,0,0,0,0,0,0,0,1,4,4,4,1,0,0,0,0,0,0,0,0,0,0,1],
    [1,0,0,4,4,0,0,0,0,0,0,0,0,0,0,0,0,0,0,0,4,4,0,0,0,0,0,0,0,0,4,4,0,0,1],
    [1,0,0,4,4,0,0,0,3,3,3,3,3,3,0,0,0,0,0,0,0,0,0,0,3,3,3,3,3,0,4,4,0,0,1],
    [1,0,0,0,0,0,0,0,3,2,2,2,3,12,3,0,0,0,0,0,0,0,0,0,3,2,2,3,12,3,0,0,0,0,1],
    [1,0,0,0,0,0,0,0,3,2,2,2,3,12,3,0,0,4,4,0,0,0,0,0,3,2,2,3,12,3,0,0,0,0,1],
    [1,0,0,0,0,0,0,0,3,2,2,2,3,12,3,0,0,4,4,0,0,0,0,0,3,2,2,3,12,3,0,0,0,0,1],
    [1,0,0,0,0,0,0,0,3,2,2,2,3,12,3,0,0,0,0,0,0,0,0,0,3,2,2,3,12,3,0,0,0,0,1],
    [1,0,0,0,0,0,0,0,3,2,2,2,3,12,3,0,0,0,0,0,0,0,0,0,3,2,2,3,12,3,0,0,0,0,1],
    [1,0,0,0,0,0,0,0,3,3,3,3,3,3,3,0,0,0,0,0,0,0,0,0,3,3,3,3,3,3,0,0,0,0,1],
    [1,3,3,3,3,3,3,3,3,0,0,0,0,0,3,3,3,3,3,3,3,3,3,3,3,0,0,0,0,0,3,3,3,3,1],
    [3,3,3,0,0,0,0,0,0,0,0,0,0,0,0,0,0,0,0,0,0,0,0,0,0,0,0,0,0,0,0,0,0,3,3],
    [1,3,3,3,3,3,3,3,3,0,0,0,0,0,3,3,3,3,3,3,3,3,3,3,3,0,0,0,0,0,3,3,3,3,1],
    [1,0,0,0,0,0,0,0,3,3,3,3,3,3,3,0,0,0,0,0,0,0,0,0,3,3,3,3,3,3,0,0,0,0,1],
    [1,0,0,0,0,0,0,0,3,2,2,2,3,12,3,0,0,0,0,0,0,0,0,0,3,2,2,3,12,3,0,0,0,0,1],
    [1,0,0,4,4,0,0,0,3,2,2,2,3,12,3,0,0,0,0,0,0,0,0,0,3,2,2,3,12,3,0,0,0,0,1],
    [1,0,0,4,4,0,0,0,3,2,2,2,3,12,3,0,0,4,4,0,0,0,0,0,3,2,2,3,12,3,0,0,0,0,1],
    [1,0,0,0,0,0,0,0,3,2,2,2,3,12,3,0,0,4,4,4,0,0,0,0,3,2,2,3,12,3,0,0,0,0,1],
    [1,0,0,0,0,0,0,0,3,2,2,2,3,12,3,0,0,0,4,4,0,0,0,0,3,2,2,3,12,3,0,0,0,0,1],
    [1,0,0,0,0,0,0,0,3,3,3,3,3,3,3,0,0,0,0,0,0,0,0,0,3,3,3,3,3,3,0,0,0,0,1],
    [1,0,0,0,0,0,0,0,0,0,0,0,0,0,0,0,0,0,0,0,0,0,0,0,0,0,0,0,0,0,0,0,0,0,1],
    [1,0,0,0,0,1,1,0,0,0,0,0,0,4,4,0,0,0,0,4,4,0,0,0,0,0,0,0,1,1,0,0,0,0,1],
    [1,0,0,0,0,0,1,1,0,0,0,0,4,4,4,0,0,0,0,4,4,4,0,0,0,0,0,1,1,0,0,0,0,0,1],
    [1,1,1,1,1,1,1,1,1,1,1,1,1,1,1,1,1,1,1,1,1,1,1,1,1,1,1,1,1,1,1,1,1,1,1]
  ],
  "exits": [
    { "col": 0, "row": 12, "targetMap": "tundra_ridge", "targetCol": 33, "targetRow": 6, "direction": "LEFT" },
    { "col": 34, "row": 12, "targetMap": "ember_town", "targetCol": 1, "targetRow": 6, "direction": "RIGHT" }
  ],
  "npcs": [
    { "npcId": "volcanic_scout", "col": 17, "row": 11 }
  ],
  "encounterZone": "volcanic_trail",
  "playerSpawn": { "x": 1, "y": 12 },
  "biomeType": "volcano",
  "isSafeZone": false
}