{
  "id": "wild_steppe",
  "name": "Wild Steppe",
  "cols": 40,
  "rows": 30,
  "grid": [
    [1,1,1,1,1,1,1,1,1,1,1,1,1,1,1,1,1,1,1,1,1,1,1,1,1,1,1,1,1,1,1,1,1,1,1,1,1,1,1,1],
    [1,0,0,0,0,0,0,0,0,0,2,2,0,0,0,0,0,2,2,0,0,0,0,0,0,0,2,2,0,0,0,0,0,0,0,0,0,0,0,1],
    [1,0,0,2,2,0,0,0,2,2,2,0,2,2,0,0,2,2,0,2,0,0,0,2,2,0,0,2,2,0,0,0,0,2,2,0,0,0,0,1],
    [1,0,2,2,0,2,0,2,2,0,2,2,0,2,2,0,2,0,2,2,2,0,0,2,0,2,2,0,2,0,0,0,2,2,0,2,0,0,0,1],
    [1,0,0,2,2,0,0,0,2,0,0,2,2,0,0,2,0,2,2,0,2,0,0,0,2,2,0,2,0,0,0,2,2,0,2,0,0,0,0,1],
    [1,0,0,0,0,0,0,2,0,2,2,0,0,2,0,0,2,0,0,2,0,0,0,2,0,0,2,0,0,0,2,2,0,2,0,0,0,0,0,1],
    [1,0,2,2,0,0,2,2,0,0,0,0,0,0,0,0,0,0,0,0,0,0,2,0,0,0,0,0,0,2,2,0,0,0,0,0,0,0,0,1],
    [1,0,0,2,2,0,0,0,0,3,3,3,0,0,0,0,0,0,0,0,0,2,2,0,0,5,5,5,5,5,0,0,0,0,0,0,2,2,0,1],
    [1,0,0,0,0,0,0,0,3,3,0,3,3,0,0,0,0,0,0,0,0,0,0,0,0,5,0,0,0,5,0,0,0,0,0,2,2,0,0,1],
    [1,0,0,2,2,0,0,0,3,0,0,0,3,0,0,2,2,0,0,0,0,0,0,0,0,5,0,9,0,5,0,0,0,0,2,2,0,0,0,1],
    [1,0,2,2,0,2,0,0,3,0,0,0,3,0,2,2,0,2,2,0,0,0,2,0,0,5,0,0,0,5,0,0,0,2,2,0,0,0,0,1],
    [1,0,0,2,0,0,0,0,3,3,0,3,3,0,0,2,2,0,2,0,0,2,2,0,0,5,5,5,5,5,0,0,2,2,0,0,0,0,0,1],
    [1,0,0,0,0,0,0,0,0,3,3,3,0,0,0,0,0,0,0,0,0,0,0,0,0,0,0,0,0,0,0,0,0,0,0,0,2,2,0,1],
    [1,0,2,0,0,0,0,0,0,0,0,0,0,0,2,2,0,0,2,2,0,0,0,0,0,2,2,0,0,0,0,0,0,0,0,2,2,0,0,1],
    [1,0,2,2,0,0,0,0,2,2,0,0,0,2,2,0,2,2,0,2,2,0,0,0,2,2,0,2,0,0,0,0,0,0,2,2,0,0,0,1],
    [1,3,3,0,0,0,2,2,2,0,2,0,0,0,2,0,0,2,2,0,2,0,0,2,2,0,2,0,0,0,0,0,2,2,0,0,0,0,0,1],
    [1,0,0,0,2,2,0,2,0,2,0,0,0,2,0,2,2,0,0,2,0,0,0,0,2,0,0,0,0,0,2,2,2,0,0,0,0,0,0,1],
    [1,0,0,2,2,0,0,0,2,0,0,0,2,2,0,0,2,0,0,0,0,0,2,0,0,0,0,4,4,4,4,0,0,0,0,0,2,2,0,1],
    [1,0,0,0,2,0,0,2,0,0,0,0,0,0,0,0,0,0,0,0,0,2,2,0,0,0,4,4,4,4,4,4,0,0,0,2,2,0,0,1],
    [1,0,2,2,0,0,0,0,0,0,0,0,0,0,2,2,0,0,0,0,0,0,0,0,0,0,0,4,4,4,4,0,0,0,2,2,0,0,0,1],
    [1,0,0,2,0,0,0,2,2,0,0,0,0,2,2,0,2,2,0,0,0,0,0,0,0,0,0,0,0,0,0,0,0,2,2,0,0,0,0,1],
    [1,0,0,0,0,0,2,2,0,2,0,0,0,0,2,2,0,2,0,0,0,0,2,2,0,0,0,0,0,0,0,0,2,2,0,0,0,0,0,1],
    [1,0,2,2,0,0,0,2,2,0,0,0,2,0,0,2,2,0,0,0,0,2,2,0,2,0,0,0,0,0,0,2,2,0,0,0,0,0,0,1],
    [1,0,0,2,2,0,0,0,0,0,0,2,2,0,0,0,0,0,0,0,0,0,2,2,0,0,0,0,0,0,2,2,0,0,0,0,2,2,0,1],
    [1,0,0,0,0,0,0,0,0,0,0,0,0,0,0,2,2,0,0,0,0,0,0,0,0,0,0,0,0,0,0,0,0,0,0,2,2,0,0,1],
    [1,0,2,2,0,0,2,0,0,0,2,2,0,0,2,2,0,2,0,0,0,0,0,2,0,0,0,0,2,2,0,0,0,0,2,2,0,0,0,1],
    [1,0,0,2,2,0,0,2,0,2,2,0,0,0,0,2,0,0,0,0,0,0,2,2,0,0,0,2,2,0,0,0,0,2,2,0,0,0,0,1],
    [1,0,0,0,2,0,0,0,0,0,0,0,0,2,0,0,0,0,0,0,0,0,0,0,0,0,0,0,0,0,0,0,0,0,0,0,0,0,0,1],
    [1,0,0,0,0,0,0,0,0,0,0,0,0,0,0,0,0,0,0,0,0,0,0,0,0,0,0,0,0,0,0,0,0,0,0,0,0,3,0,1],
    [1,1,1,1,1,1,1,1,1,1,1,1,1,1,1,1,1,1,1,1,1,1,1,1,1,1,1,1,1,1,1,1,1,1,1,1,1,1,1,1]
  ],
  "exits": [
    { "col": 1, "row": 15, "targetMap": "town", "targetCol": 27, "targetRow": 13, "direction": "LEFT" },
    { "col": 38, "row": 28, "targetMap": "waystation", "targetCol": 1, "targetRow": 6, "direction": "RIGHT" }
  ],
  "npcs": [
    { "npcId": "steppe_trainer", "col": 20, "row": 15 }
  ],
  "encounterZone": "wild_steppe",
  "playerSpawn": { "x": 1, "y": 15 },
  "biomeType": "forest",
  "isSafeZone": false
}
